-------------$#---
|       WF        |
|    ---------    |
| k            -- |
|   b  k     --   |
|------------   b |
|   --ww--     ---|
|    b       --   |
-----------ff------