---------
|   k   |
# F   W $
|  kb   |
---------